################################
# #          #                 #
# #  $  #    #     $           #
# #######    #                 #
#     #      #                 #
#   $ #      #                 #
#                  $           #
#                              #
########                       #
#                              #
#         #######              #
#         #                    #
#         #  $                 #
#         #                    #
#   $     #                    # 
################################