################################
# #          #                 #
# #     #    #     $           #
# ##         #                 #
#     #      #                 #
#   $ #      #                 #
#                  $           #
#                              #
#####                 #######$ #
#                              #
#    $                         #
#         #                    #
#         #  $                 #
#         #   #######     $    #
#  H      #                    # 
################################