################################
#              #             $ #
#   $          #               #
#              #       #       #
#              #    $  #       #
#              #       #       #
#    $                         #
#                              #
##############                 #
#      $                       #
#      #                       #
#      #       ############### #
#      #                       #
#                              #
# $    #                 H     # 
################################