################################
#         #                  $ #
#         #                    #
#         #                    #
#        $#        ########### #
#    ######                    #
#                  $           #
#                              #
#############  #################
#  $      #          #   H     #
#  ###### #          #         #
#         #          #         #
#                    ######    #
#             $                #
#                            $ # 
################################