################################
#                      $ #  $  #
#   #  H                 #     #
#   #                    #     #
#   #                    #     #
#   #                    #     #
#   #               ######     #
#   #               # $  #     #
#   #               #### #     #
#   #                    #     #
#   #   ################ #     #
#   #                    # #   #
# $ #$                         #
# ##########################   #
#   $                          # 
################################